1111111111111111111
1000100000000010001
1110101111101110101
1010100010100000101
1010111010111110101
1000100000000000101
1011111111101111101
1000001000001000101
1011101011111010101
1000101000100010101
1010101111101110101
1010101000101000101
1011101010101011101
1000000010000000001
1111111111111111111
