1111111111111111111
1000001000000000001
1110101111111011101
1000100000001010001
1110111111101010111
1000100000001010101
1011101111111010101
1000101000001010001
1010101011101011101
1010001000100000101
1011101110111110101
1000100010001000101
1110101011101010101
1000001000001010001
1111111111111111111
