1111111111111111111
1010000010000010001
1010111011101010101
1000100010001000101
1111101010101111101
1000001000101000001
1011111011101011101
1000100010101000101
1110101110101110101
1010001000100000101
1011111010111111101
1000000010000010001
1011111010111110111
1000000010000000001
1111111111111111111
