1111111111111111111
1101111101111111011
1001001000100010011
1111101111110111011
1101111111111111111
1000000000000000001
1101111111111111111
1111111111111111111
1111111111111111111
1111111111111111111
1111111111111111111
1111111111111111111
1111111111111111111
1111111111111111111
1111111111111111111
