1111111111111111111
1101111101111111011
1001001000100010011
1111101111110111011
1101111111111111111
1000000000000000001
1101111111111111111
1111111111111111111
1001011111111111111
1100011111110111111
1111000000000000001
1111010111110111111
1111000000000000001
1111110111110111111
1111111111111111111
